SRLD1337
Laser
19,11
--!WWW@------------
--RwwwL------------
--RK kL------------
--RxMXL------------
--R   L------------
--R   L------------
!WWW WWWWWWWWWWWWWL
RewwDwwwwwwwwwwwweL
R           GH    L
R r         GH  J L
#;;;;;;;;;;;;;;;;;$
(16,9)+(4,7)
--DDDDDDD--D-AAAAAA-WWWW--SS-AA